scale 2
tilemap
14 10
11111111111111
10000000010001
10000000010001
10000000010001
10p00000010001
10G00000010001
10100000010701
10000000010001
1aaaaaaaa1aaa1
11111111111111
focus 3
focus_rate_dec 2
focus_rate_inc 1