17 15
3
0 0
2
0
11111111111111111
10000000000000001
10000000000000001
10000900000000001
1000000000000a001
100000000a0088001
100p0000880000091
10080000000000081
10000000000000001
1aaaaaaaaaa000001
11111111111000001
11111111111000001
11111110001000001
11111110701aaaaa1
11111111111111111