scale 3
tilemap
9 9
aaaaaaaaa
111111111
100010001
100010001
100111001
171111171
1110p0111
111a01111
111121111
focus 2
focus_rate_dec 0
focus_rate_inc 0