14 10
3
2 1
2
0
11111111111111
10000000010001
10000000010001
10000000010001
10p00000010001
10G00000010001
10100000010701
10000000010001
1aaaaaaaa1aaa1
11111111111111