tilemap
25 18
0000000000000000000000000
0000000000000000000000000
0000000000000000000000000
0000000000000000000000000
00000000000p0000000000000
0000000000000000000000000
00000000000F0000000000000
0000000000022000000000000
0000000000000000000000000
0000000000000000000000000
0000000000000000000000000
aa00aaaaaaa00aaaaaaaa00aa
1177111111100111111117711
0000000000000000000000000
0000000000000000000000000
1111111170000007111111111
0000000010000001000000000
0000000012222221000000000
focus 5
