10 10
3
1 2
2
0
1111111111
1111001111
1111p01111
1111001111
1001001001
10010E1001
1711331171
1111001111
1111aa1111
1111111111