scale 1.2
tilemap
40 6
1111111111111111111111111111111111111111
1000000000000000000000000000000000000001
1000900009000090000p00009000009000090001
1700000000000000000220000000000000000071
1aaaaaaaaaaaaaaaaaaaaaaaaaaaaaaaaaaaaaa1
1111111111111111111111111111111111111111
focus 5
focus_rate_dec 1 
focus_rate_inc 2