16 10
0
0 0
2
0
1111111111111111
1111110000111111
1111110000111111
1000000000000001
10p0000000000001
1000000000000001
10A00B0000C00001
1111110000117111
1111110000111111
1111111111111111