scale 2
tilemap
20 11
11111111111111111111
11110000000000010001
11110000000000010001
11000000000000010001
11018880000000010001
11F0p000000000010001
11111100000000010701
11110000000000010001
11110000000100010001
1111aaaaaaa1aaa1aaa1
11111111111111111111
focus 3
