scale 2
tilemap
19 9
1111111111111111111
1000001090109010001
1000001000100010001
1000001000100010001
10p0001000100010001
1120001070107010701
1000001000100010001
1aaaaa1aaa1aaa1aaa1
1111111111111111111
focus 3