20 10
5
1 1
2.7
1
11111111111111111111
1p011111111111111111
10011111111111111111
12211111111111111111
11111111111111111111
11111111111111111111
11111111111111111111
11111111111111111001
11111111111111111001
11111111111111111771