scale 2.7
tilemap
20 10
11111111111111111111
1p011111111111111111
10011111111111111111
12211111111111111111
11111111111111111111
11111111111111111111
11111111111111111111
11111111111111111001
11111111111111111001
11111111111111111771
focus 5
focus_rate_dec 1
focus_rate_inc 1
can_tele_outside