scale 3
tilemap
17 13
00000000000000000
00000000000000000
00000110101100000
00001100100110000
00011000100011000
00111171117111100
01100010001000110
11000010p01000011
01100010E01000110
00117111711171100
00022200000222000
00022200000222000
00022200000222000
focus 8
focus_rate_inc 0.6
