tilemap
23 15
11000000000000000000011
01111111111111111111111
01000000000000000000010
01000000000700000000010
01721000000000000070010
01100000000000000013310
01000000000000000000010
010p0000013331000000010
01000000000000000000010
011F1000000000000012710
01111000000700000000010
01000000000000000000010
01aaaaaaaaaaaaaaaaaaa10
11111111111111111111111
11000000000000000000011
focus 3
focus_rate_dec 0
focus_rate_inc 0
scale 2.5