tilemap
36 10
111111111111111111111111111111111111
000000000000000000000000000000000000
000000000001111111111111100000000000
000000000011010000000000010000000000
000000700011p10000000001010007000000
000000000011010011110001010000000000
000000000011A00B100100C1000000000000
000000700011111100001171110007000000
000000000011111100001111110000000000
111111111111111111111111111111111111
scale 2
