scale 2.4
tilemap
20 16
10000000000000000001
10000000000000000001
10000000000000000001
11111111111111111111
12111111000011111121
12111110000001111121
11100000000000000111
1110p000000000000111
12100000000000000121
11D00000000000000011
12711110000001111721
1211111aaaaaa1111121
11111111111111111111
10000000000000000001
10000000000000000001
10000000000000000001