tilemap
34 10
1111111111111111111111111111111111
1111001111001111001111001111001111
1111001111001111p01111001111001111
1111001111001111001111001111001111
1111001001001001001001001001001111
1111001001001001001001001001001111
1111001711001711331171001171001111
1111001111001111001111001111001111
1111aa1111aa1111aa1111aa1111aa1111
1111111111111111111111111111111111
focus 2.5
focus_rate_dec 0.1
focus_rate_inc 5
scale 2